




111111111111111
1001000000000C1
100000010000001
1P0011E00000001
100000000000001
111111111111111


