




11111111111111111111111111111111
100100000000C0000000000000000001
100S0001000000000000000000000001
1P0011E000S000000000000000000001
10000000000000000000000000000001
11111111111111111111111111111111


