




111111111111111
100100000S000C1
100000010000001
1P0011E000S0001
100000S00000001
111111111111111


