




111111111111111
1001000000000C1
100S00010000001
1P0011E000S0001
100000000000001
111111111111111


