




111111111111111
100100000S000C1
100S00010000001
1P0011E000S0001
100000000000001
111111111111111


