1111111111111111111111111111
100C10011C0010CC0000C00S0011
10C0S001000000100100001C1C11
100001010011010C0101110C1001
1000100100100000000110011011
11100100000C00001000E0011101
1110010010000101001010110111
1100100001001000000001001011
1001001000000S00000010001111
10010011000110P0000111100001
1000C00000000100000010000001
1000001001000000100001000011
1000100110000000000000010001
10001000110000S01111010010C1
1100100010001000110010000101
110011000000010000S000000001
11000001C1C10011000001010001
11001001100000001001000C0101
100001000001C000100000101001
100S00011010C01C000S01000001
1111111111111111111111111111