111111111111111111111111111
10C10011C0010CC0000C0000111
10C0001000000100100001C1C11
100M1010011010C0101110C1001
100010100100000000110011011
1110010000C00001000E0M11101
111001010000101001010110111
110010000001000000001001011
10010010000000000001M001111
100100110011000000111100001
1000C0000000100000010000001
100000100100000100001000011
1000100110M0000000000010001
1000100011000001111010010C1
110010001000100110010000101
110011000000010000000000001
11000001C1C1001100M01010001
1100100110000000001000C0101
100001000001C00010000101001
100000011010C01C00001000001
100010000010100110011010001
10000000000100100C100011001
100001CC0010000000010000011
10000000000010001000P100011
100010000000010010000010001
1000010001111001C0000000001
10000100000001C010000000011
1110000000C0101C0000010M101
10C000000000010000M11000011
10010C010010000000000001001
101000001010000011100000011
10001C0100001C0000000000001
111111111111111111111111111