
111111111
1EC00P0E1
111111111

