11111
10011
10001
10C01
110E1
10001
1P111
10001
10001
11001
11001
10001
10011
10011
10011
11111