1111111111111
1000000000001
1000000001111
10001C0000001
1100000000101
1100001000101
1100101010011
100001E100011
1100010000P11
1000010111011
1001010000001
100111000C101
1000011010011
10000000C0001
101000000C011
1111111111111