111111111111111111111111111111111111111111111111111111111111111111111111111
11010001C110010001000000000010000C10101000010000C00000010000000000010111111
11011000001100000010101000000010000C0000110000100001001000100101000010C0001
1100000100C10001001000CC000000101000001100000000000001100010000010000000001
100111110000000100010000001P01C0001000011101000100010001000011000000E0C0C01
111111111111111111111111111111111111111111111111111111111111111111111111111