11111111111
10110010011
1000010C001
10C00110001
10000001011
10000010000
1P1000E1001
10110011101
100000C0001
11000000011
11000011001
11111111111