



111111111
1EC00P0E1
111111111



111111111
100000001
111111111